16
1,7,5,5,5,5,5,7,5,5,5,5,5,5,6,2
2,11,5,5,7,5,5,13,5,5,6,1,5,7,12,10
10,11,5,5,15,5,5,5,5,7,13,5,5,15,5,14
10,11,5,5,15,5,5,5,5,15,5,5,5,13,6,10
11,15,5,5,15,7,5,5,4,9,5,4,3,4,8,8  
10,11,7,5,14,10,3,5,5,6,2,3,15,7,7,4
10,10,11,4,10,10,11,5,5,14,10,10,10,10,8,2
10,10,8,1,14,8,10,3,6,10,10,10,10,11,5,12
11,15,6,1,13,5,12,9,14,10,10,10,10,11,5,6
10,10,10,3,5,5,5,5,14,9,13,13,13,15,5,12
8,10,8,10,3,5,5,4,10,1,5,5,5,15,5,6
1,13,4,10,11,7,5,5,14,1,5,5,5,15,5,12
2,3,7,15,14,11,5,6,10,1,5,5,5,15,5,6
10,10,10,10,10,11,5,12,11,5,5,5,5,15,5,12
11,14,10,10,10,11,5,5,15,7,5,5,5,15,5,6
8,9,13,13,12,9,5,4,8,9,5,5,5,13,5,12